cols=8
rows=8
44444444
40040004
40040405
40040044
40004004
60400404
40040004
44444444