cols=8
rows=8
11111111
10010001
10010100
10010011
10011001
00100101
10010001
11111111